1111111
1000001
100p001
10000011111
10000000001
11111111101
12000000001
10000000001
10000200001
10000000001
10000000001
12000000001
10111111101
10111111101
10111111101
10001111101
11101111101
010000000001
010200002001
010000000001
010000200001
010111111111
11000000001
11020000021
11000000001
11000200001
11000111101
11000100001
11000100001
11000100001
11111111011
11111111011
11111111011
11100000011
11101111011
11101111111
11121111111
11101111111
11101111111
11101111111
11101111111
11101111111
11101111111
11101111111
11101111111
11101111111
11101111111
11101111111
10000000001
10000000001
10000000001
10003000001
11111111111
