1111111
1000001
100p001
10000011111
10000000001
11111111101
11111000001
10000000001
10111111111
10111000001
10000000001
11111000001
11111111101
11000000001
11011111111
11011111111
11011111111
110000000001
110220202001
110000000001
110020200001
110000000001
11000200001
11020000021
11000000001
11000200001
11111110001
11000000001
11000000001
11000000001
11110011111
11110011111
11110011111
11100000011
11101111011
11101111111
11121111111
11101111111
11101111111
11101111111
11101111111
11101111111
11101111111
11101111111
11101111111
11101111111
11101111111
11101111111
10000000001
10000000001
10000000001
10004000001
11111111111

