1111111
1000001
100p001
10000011111
10000000001
10001111111
10000000001
10000000001
10000000001
10000000001
10002000001
11111110001
10000000001
10002002001
10000000001
10001111111
10002000001
10000000001
11111110001
10000000001
10200000001
10000020001
10020002001
10000000001
10202002001
10000000001
10020202001
10000000001
10200200201
10000000001
11111011111
11111011111
11111011111
11111011111
11111011111
11111011111
11111011111
11111011111
11110001111
11110000111
10000000001
11000000001
11110000111
11110001111
11111011111
11111011111
10000500001
11111111111


